[level]
tileset = images/ground.png
map =  #########################################
       #......................#........o.......#
       #...>..................#................#
       #....@.................#####.############
       #.......................................#
       #.......................................#
       #.......................................#
       #.......................................#
       #####.##############.##############.#####
       #............#...............#..........#
       #............#...............#..........#
       #............#...............#..........#
       #............#...............#..........#
       #............#...............#....s.....#
       #......r.....#.......b.......#..........#
       #............#...............#..........#
       #............#...............#..........#
       #............#...............#..........#
       #............#...............#..........#
       #########################################

[#]
name = wall
wall = true
block = true

[.]
name = floor
tile = 0, 3

[@]
name = player
tile = 0, 3
player = true
sprite = images/player.png

[s]
name = body
tile = 0, 3
body = true
sprite = images/skeleton.png

[>]
name = stairs
tile = 3, 3

[c]
name = crate
tile = 0, 3
sprite = images/crate.png
block = true

[r]
name = house
tile = 0, 3
sprite = images/house_red.png
block = true

[o]
name = house
tile = 0, 3
sprite = images/house_orange.png
block = true

[b]
name = house
tile = 0, 3
sprite = images/house_blue.png
block = true
