[level]
tileset = images/dungeon.png
map =  #########################################
       #......................#........o.......#
       #...>..................#................#
       #....@...............#.#####.############
       #.......................................#
       #.......................................#
       #.......................................#
       #.......................................#
       #####.##############.##############.#####
       #............#...............#<........>#
       #............#...............#..........#
       #............#...............#..........#
       #............#...............#...ccc....#
       #............#...............#....s.....#
       #......r.....#.......b.......#..........#
       #....n.......#...............#..........#
       #............#...............#..........#
       #............#...............#..........#
       #............#...............#..........#
       #########################################

[#]
name = wall
wall = true
block = true

[.]
name = floor
tile = 0, 3


[n]
name = npc
tile = 2, 2
npc = true
sprite = images/npc.png
block = true



[@]
name = player
tile = 0, 3
player = true
sprite = images/player_new.png

[s]
name = body
tile = 0, 3
body = true
sprite = images/skeleton.png

[>]
name = stairs
tile = 3, 3
down = true
stairs = true

[<]
name = stairs
tile = 3, 3
up = true
stairs = true

[c]
name = crate
tile = 0, 3
sprite = images/crate.png
block = true

[r]
name = house
tile = 0, 3
sprite = images/house_red.png
block = true

[o]
name = house
tile = 0, 3
sprite = images/house_orange.png
block = true

[b]
name = house
tile = 0, 3
sprite = images/house_blue.png
block = true
